{
  "name": "Arena",
  "grid": [
    [2,2,2,2,2,2,2,2,2,2,2,2,2,2,2,2,2,2,2,2,2,2,2,2,2],
    [2,4,4,4,4,4,4,4,4,4,4,4,4,4,4,4,4,4,4,4,4,4,4,4,2],
    [2,4,0,0,0,0,0,0,0,0,0,0,0,0,0,0,0,0,0,0,0,0,0,4,2],
    [2,4,0,0,0,5,0,0,0,0,0,0,0,0,0,0,0,0,0,5,0,0,0,4,2],
    [2,4,0,0,5,5,0,0,0,0,0,0,0,0,0,0,0,0,5,5,0,0,0,4,2],
    [2,4,0,0,0,0,0,0,0,0,0,0,0,0,0,0,0,0,0,0,0,0,0,4,2],
    [2,4,0,0,0,0,0,0,0,0,0,0,0,0,0,0,0,0,0,0,0,0,0,4,2],
    [2,4,0,0,0,0,0,0,0,5,0,0,0,0,5,0,0,0,0,0,0,0,0,4,2],
    [2,4,0,0,0,0,0,0,0,0,5,0,0,5,0,0,0,0,0,0,0,0,0,4,2],
    [2,4,0,0,0,0,0,0,0,0,0,5,5,0,0,0,0,0,0,0,0,0,0,4,2],
    [2,4,0,0,0,0,0,0,0,0,5,0,0,5,0,0,0,0,0,0,0,0,0,4,2],
    [2,4,0,0,0,0,0,0,0,5,0,0,0,0,5,0,0,0,0,0,0,0,0,4,2],
    [2,4,0,0,0,0,0,0,0,0,0,0,0,0,0,0,0,0,0,0,0,0,0,4,2],
    [2,4,0,0,5,5,0,0,0,0,0,0,0,0,0,0,0,0,5,5,0,0,0,4,2],
    [2,4,0,0,0,5,0,0,0,0,0,0,0,0,0,0,0,0,0,5,0,0,0,4,2],
    [2,4,0,0,0,0,0,0,0,0,0,0,0,0,0,0,0,0,0,0,0,0,0,4,2],
    [2,4,4,4,4,4,4,4,4,4,4,4,4,4,4,4,4,4,4,4,4,4,4,4,2],
    [2,2,2,2,2,2,2,2,2,2,2,2,2,2,2,2,2,2,2,2,2,2,2,2,2]
  ],
  "thrones": {
    "aliado":  [1, 1],
    "enemigo": [23, 16]
  },
  "ally_spawns": [
    {"unit_id": "HERO_ALLY",   "bando": "aliado", "pos": [3, 3]},
    {"unit_id": "CLERIC_ALLY", "bando": "aliado", "pos": [3, 5]}
  ],
  "enemy_spawns": [
    {"pos": [21, 12]},
    {"pos": [20, 14]},
    {"pos": [21,  9]}
  ],
  "items_spawn": [
    {"pos": [12, 6],  "item_id": "POTION_G"},
    {"pos": [12, 12], "item_id": "LANCE_SILVER"}
  ],
  "rules": {
    "neutral_monsters": false,
    "turn_limit": 30
  }
}
