{
  "name": "Greenfield",
  "grid": [
    [2,2,2,2,0,0,0,0,0,0,0,0,0,0,0,0,0,0,0,0,0,0,0,0,0],
    [2,1,1,2,0,0,0,0,0,0,0,0,0,0,0,0,0,0,0,0,0,0,0,0,0],
    [2,1,0,0,0,1,1,0,0,0,3,3,3,0,0,0,0,0,0,0,0,0,0,0,0],
    [0,0,0,0,0,1,1,0,0,3,3,3,3,3,0,0,0,0,0,0,0,0,0,0,0],
    [0,0,0,0,0,0,0,0,0,3,3,2,2,3,0,0,0,0,0,0,0,0,0,0,0],
    [0,0,0,1,0,0,0,0,0,0,3,2,2,0,0,0,0,0,0,0,0,0,0,0,0],
    [0,0,0,1,1,0,0,0,0,0,0,0,0,0,0,0,0,0,0,0,0,0,0,0,0],
    [0,0,0,0,0,0,0,0,0,0,0,0,0,0,0,0,1,1,0,0,0,0,0,0,0],
    [0,0,0,0,0,0,0,0,5,5,0,0,0,0,0,0,1,1,0,0,0,0,0,0,0],
    [0,0,0,0,0,1,1,0,0,0,0,0,0,0,0,0,0,0,0,0,0,0,0,0,0],
    [0,0,0,0,0,1,1,0,0,0,0,5,5,0,0,0,0,0,0,0,0,0,0,0,0],
    [0,0,0,0,0,0,0,0,0,0,0,0,0,0,0,0,0,0,0,0,0,0,0,0,0],
    [0,0,0,0,0,0,0,0,0,0,0,0,0,0,5,5,0,0,0,0,0,0,0,0,0],
    [0,0,0,0,0,0,0,0,0,0,0,0,0,0,0,0,0,0,0,1,1,0,0,0,0],
    [0,0,0,0,1,1,0,0,0,0,0,0,0,0,0,0,0,0,0,1,1,0,0,0,0],
    [0,0,0,0,1,1,0,0,0,0,0,3,3,3,0,0,0,0,0,0,0,0,0,0,0],
    [0,0,0,0,0,0,0,0,0,0,3,3,3,3,3,0,0,0,0,0,0,0,0,0,0],
    [0,0,0,0,0,0,0,0,0,0,0,3,3,3,0,0,0,0,0,0,0,0,0,0,0]
  ],
  "thrones": {
    "aliado":  [2, 2],
    "enemigo": [22, 2]
  },
  "ally_spawns": [
    {"unit_id": "HERO_ALLY",   "bando": "aliado", "pos": [5, 5]},
    {"unit_id": "CLERIC_ALLY", "bando": "aliado", "pos": [4, 7]}
  ],
  "enemy_spawns": [
    {"pos": [17, 5]},
    {"pos": [19, 9]},
    {"pos": [16, 12]}
  ],
  "items_spawn": [
    {"pos": [7,  7],  "item_id": "LANCE_SILVER"},
    {"pos": [6,  8],  "item_id": "POTION_G"},
    {"pos": [13, 11], "item_id": "ANTIDOTE"}
  ],
  "rules": {
    "neutral_monsters": false,
    "turn_limit": null
  }
}
